10
23 23
8  1  1  1  1  1  1  1  1  1  1  1  1  1  1  1  1  1  1  1  1  1  9  
12 0  0  0  0  0  0  0  8  0  0  2  0  0  9  0  0  0  0  0  0  0  12 
12 0  0  0  0  0  0  0  10 0  0  0  0  0  11 0  0  0  0  0  0  0  12 
12 0  0  0  0  0  0  0  0  0  0  0  0  0  0  0  0  0  0  0  0  0  12 
12 0  0  0  0  0  0  0  0  0  0  0  0  0  0  0  0  0  0  0  0  0  12 
12 0  0  0  0  0  0  0  11 9  0  0  0  8  10 0  0  0  0  0  0  0  12 
12 0  0  0  0  0  0  0  0  0  0  0  0  0  0  0  0  0  0  0  0  0  12 
12 0  0  0  0  0  0  0  0  0  0  0  0  0  0  0  0  0  0  0  0  0  12 
12 0  0  0  0  0  0  0  0  0  0  0  0  0  0  0  0  0  0  0  0  0  12 
12 0  0  0  0  0  0  0  0  0  0  0  0  0  0  0  0  0  0  0  0  0  12 
12 0  0  0  0  0  0  0  0  0  0  0  0  0  0  0  0  0  0  0  0  0  12 
12 0  8  1  0  0  0  0  0  0  0  0  0  0  0  0  0  0  0  1  9  0  12 
12 8  10 0  0  0  0  0  0  12 0  0  0  12 0  0  0  0  0  0  11 9  12 
12 10 0  0  0  0  0  0  0  12 0  0  0  12 0  0  0  0  0  0  0  11 12 
12 0  0  0  0  0  0  0  8  10 0  0  0  11 9  0  0  0  0  0  0  0  12 
12 0  0  0  0  0  0  0  12 0  0  0  0  0  12 0  0  0  0  0  0  0  12 
12 0  0  0  0  0  0  8  10 0  0  0  0  0  11 9  0  0  0  0  0  0  12 
12 0  0  0  0  0  8  10 0  0  0  0  0  0  0  11 9  0  0  0  0  0  12 
12 0  0  0  0  0  12 0  0  0  0  0  0  0  0  0  12 0  0  0  0  0  12 
12 0  0  0  0  0  0  0  0  0  0  0  0  0  0  0  0  0  0  0  0  0  12 
12 0  0  0  0  0  0  0  0  0  0  6  0  0  0  0  0  0  0  0  0  0  12 
12 0  0  0  0  0  0  0  0  0  0  3  0  0  0  0  0  0  0  0  0  0  12 
11 1  1  1  1  1  1  1  1  1  1  1  1  1  1  1  1  1  1  1  1  1  10 
