1000
23 23
1  1  1  1  1  1  1  1  1  1  1  1  1  1  1  1  1  1  1  1  1  1  1  
1  2  0  0  0  0  0  12 0  0  0  0  0  0  0  12 0  0  0  0  0  3  1  
1  0  0  0  0  0  0  12 0  0  0  0  0  0  0  12 0  0  0  0  0  0  1  
1  0  0  0  0  0  0  0  0  0  0  0  0  0  0  0  0  0  0  0  0  0  1  
1  0  0  0  0  0  0  0  0  0  0  0  0  0  0  0  0  0  0  0  0  0  1  
1  0  0  0  0  0  0  12 0  0  0  0  0  0  0  12 0  0  0  0  0  0  1  
1  1  1  0  0  1  1  10 0  0  0  0  0  0  0  11 1  0  0  0  1  1  1  
1  0  0  0  0  0  0  0  0  0  0  0  0  0  0  0  0  0  0  0  0  0  1  
1  0  0  0  0  0  0  0  0  0  0  0  0  0  0  0  0  0  0  0  0  0  1  
1  0  0  0  0  0  0  0  0  0  0  0  0  0  0  0  0  0  0  0  0  0  1  
1  0  0  0  0  0  0  0  0  0  0  0  0  0  0  0  0  0  0  0  0  0  1  
1  0  0  0  0  0  0  0  0  0  0  0  0  0  0  0  0  0  0  0  0  0  1  
1  0  0  0  0  0  0  0  0  0  0  0  0  0  0  0  0  0  0  0  0  0  1  
1  0  0  0  0  0  0  0  0  0  0  0  0  0  0  0  0  0  0  0  0  0  1  
1  0  0  0  0  0  0  0  0  0  0  0  0  0  0  0  0  0  0  0  0  0  1  
1  1  1  0  0  1  1  9  0  0  0  0  0  0  0  8  1  1  0  0  0  1  1  
1  0  0  0  0  0  0  12 0  0  0  0  0  0  0  12 0  0  0  0  0  0  1  
1  0  0  0  0  0  0  0  0  0  0  0  0  0  0  0  0  0  0  0  0  0  1  
1  0  0  0  0  0  0  0  0  0  0  0  0  0  0  0  0  0  0  0  0  0  1  
1  0  0  0  0  0  0  12 0  0  0  0  0  0  0  12 0  0  0  0  0  0  1  
1  0  0  0  0  0  0  12 0  0  0  0  0  0  0  12 0  0  0  0  0  0  1  
1  6  0  0  0  0  0  12 0  0  0  0  0  0  0  12 0  0  0  0  0  8  1  
1  1  1  1  1  1  1  1  1  1  1  1  1  1  1  1  1  1  1  1  1  1  1  
