1000
40 40
8  1  1  1  1  1  1  1  1  1  1  1  1  1  1  1  1  1  1  1  1  1  1  1  1  1  1  1  1  1  1  1  1  1  1  1  1  1  1  9  
12 0  0  0  0  0  0  0  0  0  0  0  0  0  0  0  0  0  0  0  0  0  0  0  0  0  0  0  0  0  0  0  0  0  0  0  0  0  2  12 
12 0  8  1  1  1  1  1  1  1  1  1  1  1  1  1  1  1  1  0  0  1  1  1  1  1  1  1  1  1  1  1  1  1  1  1  1  9  0  12 
12 0  12 0  0  0  0  0  0  0  0  0  0  0  0  0  0  0  1  0  0  1  0  0  0  0  0  0  0  0  0  0  0  0  0  0  0  12 0  12 
12 0  12 0  8  1  1  1  1  1  1  1  1  1  9  0  0  1  0  0  0  0  1  0  0  8  1  1  1  1  1  1  1  1  1  9  0  12 0  12 
12 0  12 0  12 0  0  0  0  0  0  0  0  0  12 0  1  0  0  12 12 0  0  1  0  12 0  0  0  0  0  0  0  0  0  12 0  12 0  12 
12 0  12 0  12 0  8  1  1  9  1  0  0  1  0  1  0  0  0  12 12 0  0  0  1  0  1  0  0  1  8  1  1  9  0  12 0  12 0  12 
12 0  12 0  12 0  12 0  0  1  0  0  1  0  1  0  0  12 0  12 12 0  12 0  0  1  0  1  0  0  12 0  0  12 0  12 0  12 0  12 
12 0  12 0  12 0  12 0  1  0  0  1  0  1  0  0  0  12 0  12 12 0  12 0  0  0  1  0  1  0  0  1  0  12 0  12 0  12 0  12 
12 0  12 0  12 0  11 1  0  0  1  0  1  0  0  12 0  12 0  12 12 0  12 0  12 0  0  1  0  1  0  0  1  10 0  12 0  12 0  12 
12 0  12 0  12 0  12 0  0  1  0  1  0  0  0  12 0  12 0  12 12 0  12 0  12 0  0  0  1  0  1  0  0  12 0  12 0  12 0  12 
12 0  12 0  12 0  0  0  1  0  1  0  0  12 0  12 0  12 0  12 12 0  12 0  12 0  12 0  0  1  0  1  0  0  0  12 0  12 0  12 
12 0  12 0  12 0  0  1  0  1  0  0  0  12 0  12 0  12 0  12 12 0  12 0  12 0  12 0  0  0  1  0  1  0  0  12 0  12 0  12 
12 0  12 0  12 0  1  0  1  0  0  12 0  12 0  12 0  12 0  12 12 0  12 0  12 0  12 0  12 0  0  1  0  1  0  12 0  12 0  12 
12 0  12 0  11 1  0  1  0  0  0  12 0  12 0  12 0  12 0  12 12 0  12 0  12 0  12 0  12 0  0  0  1  0  1  10 0  12 0  12 
12 0  12 0  0  0  1  0  0  12 0  12 0  12 0  12 0  12 0  12 12 0  12 0  12 0  12 0  12 0  12 0  0  1  0  0  0  12 0  12 
12 0  12 0  0  1  0  0  0  12 0  12 0  12 0  12 0  12 0  12 12 0  12 0  12 0  12 0  12 0  12 0  0  0  1  0  0  12 0  12 
12 0  12 0  1  0  0  12 0  12 0  12 0  12 0  12 0  12 0  12 12 0  12 0  12 0  12 0  12 0  12 0  0  0  0  1  0  12 0  12 
12 0  11 10 0  0  0  12 6  12 0  12 0  12 0  12 0  12 0  12 12 0  12 0  12 0  12 0  12 0  12 0  12 0  0  0  11 10 0  12 
12 0  0  0  0  1  1  1  1  1  1  1  1  1  1  1  1  1  1  1  1  1  1  1  1  1  1  1  1  1  1  1  1  1  1  0  0  0  0  12 
12 0  0  0  0  1  1  1  1  1  1  1  1  1  1  1  1  1  1  1  1  1  1  1  1  1  1  1  1  1  1  1  1  1  1  0  0  0  0  12 
12 0  8  9  0  0  0  12 0  12 0  12 0  12 0  12 0  12 0  12 12 0  12 0  12 0  12 0  12 0  12 0  12 0  0  0  1  9  0  12 
12 0  12 0  1  0  0  12 0  12 0  12 0  12 0  12 0  12 0  12 12 0  12 0  12 0  12 0  12 0  12 0  0  0  0  1  0  12 0  12 
12 0  12 0  0  1  0  0  0  12 0  12 0  12 0  12 0  12 0  12 12 0  12 0  12 0  12 0  12 0  12 0  0  0  1  0  0  12 0  12 
12 0  12 0  0  0  1  0  0  12 0  12 0  12 0  12 0  12 0  12 12 0  12 0  12 0  12 0  12 0  0  0  0  1  0  0  0  12 0  12 
12 0  12 0  8  1  0  1  0  0  0  12 0  12 0  12 0  12 0  12 12 0  12 0  12 0  12 0  12 0  0  0  1  0  1  9  0  12 0  12 
12 0  12 0  12 0  1  0  1  0  0  12 0  12 0  12 0  12 0  12 12 0  12 0  12 0  12 0  0  0  0  1  0  1  0  12 0  12 0  12 
12 0  12 0  12 0  0  1  0  1  0  0  0  12 0  12 0  12 0  12 12 0  12 0  12 0  12 0  0  0  1  0  1  0  0  12 0  12 0  12 
12 0  12 0  12 0  0  0  1  0  1  0  0  12 0  12 0  12 0  12 12 0  12 0  12 0  0  0  0  1  0  1  0  0  0  12 0  12 0  12 
12 0  12 0  12 0  12 0  0  1  0  1  0  0  0  12 0  12 0  12 12 0  12 0  12 0  0  0  1  0  1  0  0  12 0  12 0  12 0  12 
12 0  12 0  12 0  8  1  0  0  1  0  1  0  0  12 0  12 0  12 12 0  12 0  0  0  0  1  0  1  0  0  1  9  0  12 0  12 0  12 
12 0  12 0  12 0  12 0  1  0  0  1  0  1  0  0  0  12 0  12 12 0  12 0  0  0  1  0  1  0  0  1  0  12 0  12 0  12 0  12 
12 0  12 0  12 0  12 0  0  12 0  0  1  0  1  0  0  12 0  12 12 0  0  0  0  1  0  1  0  0  12 0  0  12 0  12 0  12 0  12 
12 0  12 0  12 0  11 1  1  10 1  0  0  1  0  1  0  0  0  12 12 0  0  0  1  0  1  0  0  1  11 1  1  10 0  12 0  12 0  12 
12 0  12 0  12 0  0  0  0  0  0  0  0  0  12 0  1  0  0  12 12 0  0  1  0  12 0  0  0  0  0  0  0  0  0  12 0  12 0  12 
12 0  12 0  11 1  1  1  1  1  1  1  1  1  10 0  0  1  0  0  0  0  1  0  0  11 1  1  1  1  1  1  1  1  1  10 0  12 0  12 
12 0  12 0  0  0  0  0  0  0  0  0  0  0  0  0  0  0  1  0  0  12 0  0  0  0  0  0  0  0  0  0  0  0  0  0  0  12 0  12 
12 0  11 1  1  1  1  1  1  1  1  1  1  1  1  1  1  1  1  0  0  11 1  1  1  1  1  1  1  1  1  1  1  1  1  1  1  10 0  12 
12 3  0  0  0  0  0  0  0  0  0  0  0  0  0  0  0  0  0  0  0  0  0  0  0  0  0  0  0  0  0  0  0  0  0  0  0  0  0  12 
11 1  1  1  1  1  1  1  1  1  1  1  1  1  1  1  1  1  1  1  1  1  1  1  1  1  1  1  1  1  1  1  1  1  1  1  1  1  1  10 
