1000
10 10
1  1  1  1  1  1  1  1  1  1  
1  3  1  1  1  1  1  1  2  1  
1  0  1  1  1  1  6  1  0  1  
1  0  1  1  1  0  0  1  0  1  
1  0  1  1  0  0  1  1  0  1  
1  0  1  1  0  0  0  0  0  1  
1  0  1  1  1  1  1  1  0  1  
1  0  1  1  1  1  1  1  0  1  
1  0  0  0  0  0  0  0  0  1  
1  1  1  1  1  1  1  1  1  1  
