1000
20 20
1  1  1  1  1  1  1  1  1  1  1  1  1  1  1  1  1  1  1  1  
1  0  0  0  0  0  0  0  0  0  0  0  0  0  0  0  0  0  0  1  
1  0  8  1  1  1  1  1  0  0  0  1  0  1  0  0  0  1  0  1  
1  0  12 0  0  0  0  0  1  0  0  0  1  0  0  0  1  0  0  1  
1  0  12 0  0  0  0  0  0  1  0  1  0  1  0  1  0  0  0  1  
1  0  12 0  1  1  9  0  0  0  1  0  0  0  1  0  0  0  0  1  
1  0  12 0  0  2  12 0  0  0  0  0  0  0  0  0  0  0  0  1  
1  0  11 1  1  1  10 8  1  1  1  1  1  1  1  1  1  9  0  1  
1  0  0  0  0  0  0  12 0  0  0  0  0  0  12 0  0  12 0  1  
1  0  0  0  0  0  0  12 0  0  0  0  0  0  12 0  0  12 0  1  
1  0  0  0  0  0  0  12 0  1  1  9  0  0  0  1  1  0  0  1  
1  0  0  0  0  0  0  12 0  0  6  12 0  0  0  0  0  0  0  1  
1  0  0  1  1  1  1  11 1  1  1  10 0  0  0  0  0  0  0  1  
1  0  1  3  0  0  0  0  0  0  0  0  0  1  0  0  0  1  0  1  
1  0  0  1  1  1  0  1  1  0  0  0  1  0  1  0  1  0  0  1  
1  0  0  0  0  0  1  0  0  1  0  1  0  0  0  1  0  0  0  1  
1  0  1  1  1  1  0  1  1  0  1  0  0  0  1  0  0  0  0  1  
1  0  0  0  0  0  0  0  0  0  0  0  0  0  0  0  0  0  0  1  
1  0  0  0  0  0  0  0  0  0  0  0  0  0  0  0  0  0  0  1  
1  1  1  1  1  1  1  1  1  1  1  1  1  1  1  1  1  1  1  1  
