1000
23 23
8  1  1  1  1  1  1  1  1  1  1  1  1  1  1  1  1  1  1  1  1  1  9  
12 0  0  0  0  0  0  0  0  0  0  3  0  0  0  0  0  0  0  0  0  0  12 
12 0  0  0  0  0  0  0  0  0  0  0  0  0  0  0  0  0  0  0  0  0  12 
12 0  0  0  0  8  9  0  0  0  0  0  0  0  0  0  8  9  0  0  0  0  12 
12 0  0  0  0  12 12 0  0  0  0  0  0  0  0  0  12 12 0  0  0  0  12 
12 0  0  0  0  11 10 0  0  0  0  0  0  0  0  0  11 10 0  0  0  0  12 
12 0  0  0  0  0  0  0  0  0  0  0  0  0  0  0  0  0  0  0  0  0  12 
12 0  0  0  0  0  0  0  0  0  0  0  0  0  0  0  0  0  0  0  0  0  12 
12 0  0  0  0  8  9  0  0  0  0  0  0  0  0  0  8  9  0  0  0  0  12 
12 0  0  0  0  11 10 0  0  0  0  0  0  0  0  0  11 10 0  0  0  0  12 
12 0  0  0  0  0  0  0  0  0  0  0  0  0  0  0  0  0  0  0  0  0  12 
12 0  0  0  0  0  0  0  0  0  0  0  0  0  0  0  0  0  0  0  0  0  12 
12 0  0  0  0  8  9  0  0  0  0  0  0  0  0  0  8  9  0  0  0  0  12 
12 0  0  0  0  11 10 0  0  0  0  0  0  0  0  0  11 10 0  0  0  0  12 
12 0  0  0  0  0  0  0  0  0  0  0  0  0  0  0  0  0  0  0  0  0  12 
12 0  0  0  0  0  0  0  0  0  0  0  0  0  0  0  0  0  0  0  0  0  12 
12 0  0  0  0  8  9  0  0  0  0  0  0  0  0  0  8  9  0  0  0  0  12 
12 0  0  0  0  12 12 0  0  0  0  0  0  0  0  0  12 12 0  0  0  0  12 
12 0  0  0  0  11 10 0  0  0  0  6  0  0  0  0  11 10 0  0  0  0  12 
12 0  0  0  0  0  0  0  0  0  0  0  0  0  0  0  0  0  0  0  0  0  12 
12 0  0  0  0  0  0  0  0  0  0  0  0  0  0  0  0  0  0  0  0  0  12 
12 0  0  0  0  0  0  0  0  0  0  2  0  0  0  0  0  0  0  0  0  0  12 
11 1  1  1  1  1  1  1  1  1  1  1  1  1  1  1  1  1  1  1  1  1  10 
