1000
23 21
8  1  1  1  1  1  1  1  1  1  1  1  1  1  1  1  1  1  1  1  9  
12 1  1  1  1  1  1  1  1  1  3  1  1  1  1  1  1  1  1  1  12 
12 0  0  0  0  0  0  0  0  0  0  0  0  0  0  0  0  0  0  0  12 
12 0  0  0  0  0  0  0  0  0  0  0  0  0  0  0  0  0  0  0  12 
12 0  0  8  1  1  1  1  1  1  1  1  1  1  1  1  1  9  0  0  12 
12 0  0  12 0  0  0  0  0  0  0  0  0  0  0  0  0  12 0  0  12 
12 0  0  12 0  0  0  0  0  0  0  0  0  0  0  0  0  12 0  0  12 
12 0  0  12 0  0  0  0  0  0  0  0  0  0  0  0  0  12 0  0  12 
12 0  0  0  0  0  0  0  0  0  0  0  0  0  0  0  0  0  0  0  12 
12 0  0  0  0  0  0  0  0  0  0  0  0  0  0  0  0  0  0  0  12 
12 0  0  0  0  0  0  0  0  0  0  0  0  0  0  0  0  0  0  0  12 
12 0  0  0  0  0  0  0  0  1  6  1  0  0  0  0  0  0  0  0  12 
12 0  0  0  0  0  0  0  0  0  1  0  0  0  0  0  0  0  0  0  12 
12 0  0  0  0  0  0  0  0  0  0  0  0  0  0  0  0  0  0  0  12 
12 0  0  0  0  0  0  0  0  0  0  0  0  0  0  0  0  0  0  0  12 
12 0  0  12 0  0  0  0  0  0  0  0  0  0  0  0  0  12 0  0  12 
12 0  0  12 0  0  0  0  0  0  0  0  0  0  0  0  0  12 0  0  12 
12 0  0  12 0  0  0  0  0  0  0  0  0  0  0  0  0  12 0  0  12 
12 0  0  11 1  1  1  1  1  1  1  1  1  1  1  1  1  10 0  0  12 
12 0  0  0  0  0  0  0  0  0  0  0  0  0  0  0  0  0  0  0  12 
12 0  0  0  0  0  0  0  0  0  0  0  0  0  0  0  0  0  0  0  12 
12 1  1  1  1  1  1  1  1  1  2  1  1  1  1  1  1  1  1  1  12 
11 1  1  1  1  1  1  1  1  1  1  1  1  1  1  1  1  1  1  1  10 
